+	+	+	w	w	w	l	k	x	f
i	x	x	w	x	x	x	x	x	v
i	x	x	w	x	x	x	x	x	+
i	x	x	w	x	x	x	x	x	+
i	v	v	w	l	l	l	x	x	+
+	+	+	+	+	+	+	+	p	d
i	v	v	+	+	l	l	x	x	p
i	x	x	+	+	+	x	x	x	+
i	x	x	x	x	+	x	x	x	+
s	x	x	c	+	+	+	+	+	+
									
a	x	a	x	x	x	x	x	x	x
x	x	x	x	x	x	x	x	x	x
a	x	a	x	x	x	x	x	x	x
x	x	x	x	x	x	x	x	x	x
x	x	x	x	x	x	x	x	x	x
x	x	x	x	x	x	x	x	x	x
x	x	x	x	x	x	x	x	x	x
x	x	x	x	x	x	x	x	x	x
x	x	x	x	x	x	x	x	x	x
x	x	x	x	x	x	x	x	x	x
